111111111111111111111
100242220200024002001
101212121010121012101
122022222022020220221
121210101210121012101
122040220000040000021
101010101210121010101
102202000202000202201
101210101012101010101
120222422020202020221
101210101212121212101
122220020020202020021
101210101210101012101
100040022020202040221
101210101210141010101
102202000202000202001
111111111111111111111
