111111111111111111111
100000000000000000001
111010111111111110111
141010000000000122221
101011111111110142221
101000000000010122221
101111101111210111101
100000001000010000001
111111111011110111111
122224221000000100201
124222221111010101201
100000000000010001201
121111211111111111201
100000001020000002001
100010000000001000001
100200004000004001001
111111111111111111111
