111111111111111111111
104000400040004000401
102020202020202020201
102020202020202020201
102020202020202020201
102020202020202020201
102020202020202020201
102020202020202020201
102020202020202020201
102020202020202020201
102020202020202020201
102020202020202020201
102020202020202020201
102020202020202020201
102020202020202020201
100040004000400040001
111111111111111111111
