111111111111111111111
100000000000000000001
111111111111111111101
100000000000000000101
101111111111111110101
101000000000000010101
101011111111111010101
101010000400001010101
101010111111101010101
101010000000001010101
101010111111111010101
101010000000000010101
121011111111111110101
101000000000000000101
101111111111111111101
100000004000002000001
111111111111111111111
