111111111111111111111
100002000000002400001
101010101010101010101
100020204002020202001
141010101210101010121
102000000000022200001
101210101210121210121
102200000200002000041
101010101010101010101
122022200002000002001
101010141010101010101
120020000002000002001
101010121010101010101
122044200002000002001
101010101014101010101
102200000200002000021
111111111111111111111
