111111111111111111111
100000000000000000001
100000000000000000001
111111111101111111111
122224222222222222221
122222222224222222221
122222242222224222221
122242222222222222221
122222222222222222221
122242222242222222221
122222222222222422221
122222222222222222221
100000000000000000001
122222222222222222221
100000000000000000001
100000000000000000001
111111111111111111111
