111111111111111111111
100000000000000000001
104444000000000000001
100000004444400000001
100000000000000000001
144000000044000000001
100000000000004440001
100000444400000000001
100000000000400000001
100044000000000044001
100000000440000000001
100000000000004400001
100444000000000000001
100000000000004440001
100000044440000000001
100000000000000000001
111111111111111111111
