111111111111111111111
100000000000000000001
104000000111111111401
101000000100000000001
101000000100000000001
101000000100000000001
101000000100000000001
101000000140000000001
101000004111111111101
101111111114000000101
100000000410000000101
100000000010000000101
100000000010000000101
100000000010000000101
104111111110000000401
100000000000000000001
111111111111111111111
