111111111111111111111
100200002200040002201
101010101210101012101
102200020022000220021
101010101010101010101
124200022044000020221
101010101012101210101
122002000000020000401
101010101010101010101
122202002002020400201
101010101012101210101
100400002000024000201
101010101012101210101
122002002002020200201
101010101010101010101
122004002220000004001
111111111111111111111
