111111111111111111111
100000000400020200001
101010101010101010101
140200000000202020001
101010101010101010101
100004222002040002001
121010101010101010101
120020020044000004201
101010121010121210101
100022000220004000221
101010101010101010101
100000400200200020021
101010101010101010101
102442000220002000221
101010121010121210101
120020020022040002201
111111111111111111111
