111111111111111111111
100000000000000000001
121412121212121412101
100000000000000000001
121412121212121212141
100000000000000000001
121212121214121214121
100000000000000000001
121212121214121212121
100000000000000000001
141212121212121212121
100000000000000000001
121212121212121214121
100000000000000000001
121214121212141212121
100000000000000000001
111111111111111111111
