111111111111111111111
100000000440000000001
100000000440000000001
100000000440000000001
100000000440000000001
100000000440000000001
100000000440000000001
100000000440000000001
144444444444444444441
144444444444444444441
100000000440000000001
100000000440000000001
100000000440000000001
100000000440000000001
100000000440000000001
100000000440000000001
111111111111111111111
