111111111111111111111
100000000000000000001
100000000000000000001
102222220200000000001
102000000220000020001
102000000202000020001
102222220200200020001
102000000200020020001
102000000200002020001
102000000200000220001
102222220200000020001
100000000000000000001
100000022200000000001
100000020022000000001
100000020002000000001
100000022220000000001
111111111111111111111
