111111111111111111111
100020000000000000001
101012101014101012101
120000022002000002001
101010101010101010101
120020220020000000201
101010121210121410121
102400000000020200001
101111111111111111141
100000002000020200001
101010101010101010101
100002000000002400001
101010101010101010101
100000002000020200001
101210101410101010121
102200000000020200001
111111111111111111111
